2_2.55_-5_0_0_0.8_0.8
1_3.5_-2_0_0_1_1_21
1_3.5_-3_0_0_1_1_21
1_3.5_-5_0_0_1_1_21
1_3.5_-6_0_0_1_1_21
1_3.5_-7_0_0_1_1_21
1_3.5_-8_0_0_1_1_21
1_4.5_-8_0_0_1_1_21
1_3.5_-4_0_0_1_1_21
1_1.5_-2_0_0_1_1_21
1_1.5_-3_0_0_1_1_21
1_1.5_-8_0_0_1_1_21
1_1.5_-7_0_0_1_1_21
1_1.5_-6_0_0_1_1_21
1_1.5_-5_0_0_1_1_21
1_1.5_-4_0_0_1_1_21
1_0.5_-8_0_0_1_1_21
1_5.5_-8_0_0_1_1_21
1_5.5_-9_0_0_1_1_21
1_6.5_-9_0_0_1_1_21
1_-1_-8_0_0_1_1_21
1_0_-8_0_0_1_1_21
1_-1_-9_0_0_1_1_21
1_-1_-10_0_0_1_1_21
1_6.5_-8_0_0_1_1_21
1_7.5_-9_0_0_1_1_21
1_7.5_-9_0_0_1_1_21
1_7.5_-8_0_0_1_1_21
1_7.5_-10_0_0_1_1_21
1_7.5_-11_0_0_1_1_21
1_-2_-11_0_0_1_1_21
1_-1_-11_0_0_1_1_21
1_-2_-12_0_0_1_1_21
1_-2_-13_0_0_1_1_21
1_-1_-13_0_0_1_1_21
1_0_-13_0_0_1_1_21
1_1_-13_0_0_1_1_21
1_2_-13_0_0_1_1_21
1_3_-13_0_0_1_1_21
1_7.5_-12_0_0_1_1_21
11_4.5_-9_0_0_1_1_levels/lobby_0
13_2.5_-5.90525_0_0_1_1_20_2.5_-5_3