9_0_-8_0_0_63_10.5_29
11_60_-2_0_0_1_1_levels/lobby_0
1_-1_0_0_0_1_1_31
1_0_0_0_0_1_1_31
1_1_0_0_0_1_1_31
1_4_0_0_0_1_1_31
1_5_0_0_0_1_1_31
1_3_0_0_0_1_1_31
1_2_0_0_0_1_1_31
1_6_0_0_0_1_1_31
1_7_0_0_0_1_1_31
1_8_0_0_0_1_1_31
1_9_0_0_0_1_1_31
1_10_0_0_0_1_1_31
1_11_0_0_0_1_1_31
1_12_0_0_0_1_1_31
1_13_0_0_0_1_1_31
1_14_0_0_0_1_1_31
1_15_0_0_0_1_1_31
1_16_0_0_0_1_1_31
1_17_-1_0_0_1_1_31
1_18_-1_0_0_1_1_31
1_19_0_0_0_1_1_31
1_20_0_0_0_1_1_31
1_24_0_0_0_1_1_31
1_23_0_0_0_1_1_31
1_22_0_0_0_1_1_31
1_21_0_0_0_1_1_31
1_25_0_0_0_1_1_31
1_26_0_0_0_1_1_31
1_28_0_0_0_1_1_31
1_30_0_0_0_1_1_31
1_27_0_0_0_1_1_31
1_29_0_0_0_1_1_31
1_31_0_0_0_1_1_31
1_32_0_0_0_1_1_31
1_34_-1_0_0_1_1_31
1_35_-1_0_0_1_1_31
1_33_-1_0_0_1_1_31
1_37_-1_0_0_1_1_31
1_36_-1_0_0_1_1_31
1_38_-1_0_0_1_1_31
1_39_0_0_0_1_1_31
1_40_0_0_0_1_1_31
1_41_0_0_0_1_1_31
1_42_0_0_0_1_1_31
1_43_-1_0_0_1_1_31
1_44_-1_0_0_1_1_31
1_45_-1_0_0_1_1_31
1_46_-1_0_0_1_1_31
1_47_-1_0_0_1_1_31
1_48_-1_0_0_1_1_31
1_49_-1_0_0_1_1_31
1_49_-2_0_0_1_1_31
1_49_-3_0_0_1_1_31
1_49_-4_0_0_1_1_31
1_49_-4_0_0_1_1_31
1_49_-5_0_0_1_1_31
1_49_-5_0_0_1_1_31
1_50_-5_0_0_1_1_31
1_50_-4_0_0_1_1_31
1_51_-3_0_0_1_1_31
1_51_-2_0_0_1_1_31
1_51_-2_0_0_1_1_31
1_51_-1_0_0_1_1_31
1_54_-1_0_0_1_1_31
1_53_-1_0_0_1_1_31
1_52_-1_0_0_1_1_31
1_45_-9_0_0_1_1_31
1_46_-9_0_0_1_1_31
1_48_-9_0_0_1_1_31
1_49_-9_0_0_1_1_31
1_47_-9_0_0_1_1_31
1_50_-9_0_0_1_1_31
1_51_-9_0_0_1_1_31
1_54_-9_0_0_1_1_31
1_52_-9_0_0_1_1_31
1_53_-9_0_0_1_1_31
1_55_-9_0_0_1_1_31
1_57_-9_0_0_1_1_31
1_58_-9_0_0_1_1_31
1_56_-9_0_0_1_1_31
1_59_-9_0_0_1_1_31
1_60_-9_0_0_1_1_31
1_61_-9_0_0_1_1_31
1_62_-9_0_0_1_1_31
1_44_-9_0_0_1_1_31
1_42_-9_0_0_1_1_31
1_43_-9_0_0_1_1_31
1_62_-1_0_0_1_1_31
1_61_-1_0_0_1_1_31
1_60_-1_0_0_1_1_31
1_59_-1_0_0_1_1_31
1_58_-1_0_0_1_1_31
1_57_-1_0_0_1_1_31
1_56_-1_0_0_1_1_31
1_55_-1_0_0_1_1_31
1_63_-1_0_0_1_1_31
1_63_-2_0_0_1_1_31
1_63_-3_0_0_1_1_31
1_63_-4_0_0_1_1_31
1_63_-6_0_0_1_1_31
1_63_-5_0_0_1_1_31
1_63_-7_0_0_1_1_31
1_63_-8_0_0_1_1_31
1_63_-9_0_0_1_1_31
1_41_-9_0_0_1_1_31
1_40_-9_0_0_1_1_31
1_39_-9_0_0_1_1_31
1_37_-9_0_0_1_1_31
1_35_-9_0_0_1_1_31
1_38_-9_0_0_1_1_31
1_36_-9_0_0_1_1_31
1_34_-9_0_0_1_1_31
1_33_-9_0_0_1_1_31
1_31_-9_0_0_1_1_31
1_32_-9_0_0_1_1_31
1_30_-9_0_0_1_1_31
1_29_-9_0_0_1_1_31
1_28_-9_0_0_1_1_31
1_26_-9_0_0_1_1_31
1_27_-9_0_0_1_1_31
1_25_-9_0_0_1_1_31
1_24_-9_0_0_1_1_31
1_23_-9_0_0_1_1_31
1_21_-9_0_0_1_1_31
1_20_-9_0_0_1_1_31
1_22_-9_0_0_1_1_31
1_19_-9_0_0_1_1_31
1_18_-9_0_0_1_1_31
1_17_-9_0_0_1_1_31
1_15_-9_0_0_1_1_31
1_13_-9_0_0_1_1_31
1_16_-9_0_0_1_1_31
1_14_-9_0_0_1_1_31
1_12_-9_0_0_1_1_31
1_11_-9_0_0_1_1_31
1_10_-9_0_0_1_1_31
1_9_-9_0_0_1_1_31
1_7_-10_0_0_1_1_31
1_6_-9_0_0_1_1_31
1_8_-10_0_0_1_1_31
1_8_-9_0_0_1_1_31
1_7_-9_0_0_1_1_31
1_2_-9_0_0_1_1_31
1_4_-9_0_0_1_1_31
1_3_-9_0_0_1_1_31
1_5_-9_0_0_1_1_31
1_1_-9_0_0_1_1_31
1_0_-9_0_0_1_1_31
1_-1_-9_0_0_1_1_31
1_-1_-8_0_0_1_1_31
1_-1_-7_0_0_1_1_31
1_-1_-6_0_0_1_1_31
1_-1_-5_0_0_1_1_31
1_-1_-4_0_0_1_1_31
1_-1_-3_0_0_1_1_31
1_-1_-2_0_0_1_1_31
1_-1_-1_0_0_1_1_31
2_0.6_-0.8_0_0_0.8_0.8
15_55_-6_0_0_1_1
22_1_-1_0_0_14_1_4_0_1_0
22_15_-2_0_0_3_2_0_-0.5_1_1
22_17_-2_0_0_16_2_1_0_0_1
22_31_-2_0_0_3_2_0_-0.5_1_1
22_33_-2_0_0_10_2_1_0_0_1
22_41_-2_0_0_3_2_0_-0.2_1_1
22_43_-2_0_0_6.5_2_1_0_0_1
22_47_-6_0_0_2.5_6_0_-0.2_1_1
22_47.5_-6_0_0_9.5_6_1_0_0_1
22_15_-6_0_0_4.5_3_2_0_0_1
22_39_-3_0_0_4.5_1_0.2_0_1_1