9_0_-8_0_0_63.5_10.5_33
2_1.62261_-0.8_0_0_0.8_0.8
1_0_0_0_0_1_1_31
1_1_0_0_0_1_1_31
1_2_0_0_0_1_1_31
1_3_0_0_0_1_1_31
1_4_0_0_0_1_1_31
1_5_0_0_0_1_1_31
1_6_0_0_0_1_1_31
1_7_0_0_0_1_1_31
1_8_0_0_0_1_1_31
1_9_0_0_0_1_1_31
1_10_0_0_0_1_1_31
1_11_0_0_0_1_1_31
1_12_0_0_0_1_1_31
1_14.5_-1_0_0_1_1_31
1_15.5_-1_0_0_1_1_31
1_16.5_-1_0_0_1_1_31
1_17.5_-1_0_0_1_1_31
1_20.5_-2_0_0_1_1_31
1_21.5_-2_0_0_1_1_31
1_22.5_-2_0_0_1_1_31
1_23.5_-2_0_0_1_1_31
1_26.5_-3_0_0_1_1_31
1_27.5_-3_0_0_1_1_31
1_27.5_-2_0_0_1_1_31
1_27.5_-1_0_0_1_1_31
1_27.5_0_0_0_1_1_31
1_27.5_1_0_0_1_1_31
1_27.5_2_0_0_1_1_31
1_28.5_1_0_0_10_1_31
1_36.5_0_0_0_1_1_31
1_36.5_-1_0_0_1_1_31
1_36.5_-2_0_0_1_1_31
1_36.5_-3_0_0_1_1_31
1_37.5_-3_0_0_1_1_31
1_40.5_-2_0_0_6_1_31
1_50.5_0_0_0_13_1_31
1_36.5_2_0_0_1_1_31
1_-1_0_0_0_1_1_31
1_-1_-1_0_0_1_1_31
1_-1_-2_0_0_1_1_31
1_-1_-3_0_0_1_1_31
1_-2_-4_0_0_1_1_31
1_-1_-4_0_0_1_1_31
1_-1_-5_0_0_1_1_31
1_-1_-6_0_0_1_1_31
1_-1_-8_0_0_1_1_31
1_-1_-7_0_0_1_1_31
1_0_-9_0_0_1_1_31
1_1_-10_0_0_1_1_31
1_-1_-9_0_0_1_1_31
1_1_-9_0_0_1_1_31
1_2_-9_0_0_1_1_31
1_2.5_-9_0_0_1_1_31
1_3.5_-9_0_0_1_1_31
1_4.5_-9_0_0_1_1_31
1_5.5_-9_0_0_1_1_31
1_6.5_-9_0_0_1_1_31
1_7.5_-9_0_0_1_1_31
1_8.5_-9_0_0_1_1_31
1_9.5_-9_0_0_1_1_31
1_10.5_-9_0_0_1_1_31
1_11.5_-9_0_0_1_1_31
1_12.5_-9_0_0_1_1_31
1_13.5_-9_0_0_1_1_31
1_14.5_-9_0_0_1_1_31
1_15.5_-9_0_0_1_1_31
1_16.5_-9_0_0_1_1_31
1_17.5_-9_0_0_1_1_31
1_18.5_-9_0_0_1_1_31
1_19.5_-9_0_0_1_1_31
1_20.5_-9_0_0_1_1_31
1_21.5_-9_0_0_1_1_31
1_22.5_-9_0_0_1_1_31
1_23.5_-9_0_0_1_1_31
1_24.5_-9_0_0_1_1_31
1_25.5_-9_0_0_1_1_31
1_26.5_-9_0_0_1_1_31
1_27.5_-9_0_0_1_1_31
1_28.5_-9_0_0_1_1_31
1_30_-9_0_0_1_1_31
1_29.5_-9_0_0_1_1_31
1_31_-9_0_0_1_1_31
1_32.5_-9_0_0_1_1_31
1_32_-9_0_0_1_1_31
1_33.5_-9_0_0_1_1_31
1_34.5_-9_0_0_1_1_31
1_35.5_-9_0_0_1_1_31
1_36.5_-9_0_0_1_1_31
1_37.5_-9_0_0_1_1_31
1_38.5_-9_0_0_1_1_31
1_39.5_-9_0_0_1_1_31
1_40.5_-9_0_0_1_1_31
1_41.5_-9_0_0_1_1_31
1_42.5_-9_0_0_1_1_31
1_43.5_-9_0_0_1_1_31
1_44.5_-9_0_0_1_1_31
1_45.5_-9_0_0_1_1_31
1_46.5_-9_0_0_1_1_31
1_47.5_-9_0_0_1_1_31
1_48.5_-9_0_0_1_1_31
1_49.5_-9_0_0_1_1_31
1_50.5_-9_0_0_1_1_31
1_51.5_-9_0_0_1_1_31
1_52.5_-9_0_0_1_1_31
1_53.5_-9_0_0_1_1_31
1_54.5_-9_0_0_1_1_31
1_55.5_-9_0_0_1_1_31
1_56.5_-9_0_0_1_1_31
1_57.5_-9_0_0_1_1_31
1_58.5_-9_0_0_1_1_31
1_59.5_-9_0_0_1_1_31
1_60.5_-9_0_0_1_1_31
1_61.5_-9_0_0_1_1_31
1_62.5_-9_0_0_1_1_31
1_63.5_-8_0_0_1_1_31
1_63.5_-9_0_0_1_1_31
1_63.5_-8_0_0_1_1_31
1_63.5_-7_0_0_1_1_31
1_63.5_0_0_0_1_1_31
1_63.5_-1_0_0_1_1_31
1_63.5_-2_0_0_1_1_31
1_63.5_-3_0_0_1_1_31
1_63.5_-4_0_0_1_1_31
1_63.5_-5_0_0_1_1_31
1_63.5_-6_0_0_1_1_31
3_13.5_-1_0_0_0.5_0.3_31
3_19.5_-2_0_0_0.5_0.3_31
3_25.5_-3_0_0_0.5_0.3_31
5_38.5_-3_0_0_0.5_0.3_31
5_46.5_-2_0_0_0.5_0.3_31
5_48.5_-1_0_0_0.5_0.3_31
10_0_-3_0_0_1_0.3_31
10_1_-3_0_0_1_0.3_31
10_2_-3_0_0_1_0.3_31
10_3_-3_0_0_1_0.3_31
10_3.5_-3_0_0_1_0.3_31
10_11.5_-4_0_0_1_0.3_31
10_12.5_-4_0_0_1_0.3_31
10_13.5_-4_0_0_1_0.3_31
10_14.5_-4_0_0_1_0.3_31
10_15.5_-4_0_0_1_0.3_31
10_18.5_-5_0_0_1_0.3_31
10_19.5_-5_0_0_1_0.3_31
10_20.5_-5_0_0_1_0.3_31
10_26.5_-6_0_0_1_0.3_31
10_27.5_-6_0_0_1_0.3_31
10_36.5_-6_0_0_1_0.3_31
10_37.5_-6_0_0_1_0.3_31
10_46.5_-5_0_0_1_0.3_31
10_47.5_-5_0_0_1_0.3_31
10_48.5_-5_0_0_1_0.3_31
10_49.5_-5_0_0_1_0.3_31
10_56.5_-2_0_0_1_0.3_31
10_57.5_-2_0_0_1_0.3_31
10_58.5_-2_0_0_1_0.3_31
10_59.5_-2_0_0_1_0.3_31
10_59.5_-4_0_0_1_0.3_31
10_60.5_-4_0_0_1_0.3_31
10_61.5_-4_0_0_1_0.3_31
10_58.5_-7_0_0_1_0.3_31
10_59.5_-7_0_0_1_0.3_31
10_60.5_-7_0_0_1_0.3_31