9_0_-8_0_0_63.5_10.5_32
1_0_0_0_0_1_1_31
1_2_0_0_0_1_1_31
1_1_0_0_0_1_1_31
1_3_0_0_0_1_1_31
1_4_0_0_0_1_1_31
1_5_0_0_0_1_1_31
1_6_0_0_0_1_1_31
1_7_0_0_0_1_1_31
1_8_0_0_0_1_1_31
1_9_0_0_0_1_1_31
1_10_0_0_0_1_1_31
1_11_0_0_0_1_1_31
1_12_0_0_0_1_1_31
1_13_0_0_0_1_1_31
1_14_0_0_0_1_1_31
1_15_0_0_0_1_1_31
1_16_0_0_0_1_1_31
1_17_0_0_0_1_1_31
1_20.5_2_0_0_1_1_31
1_19.5_2_0_0_1_1_31
1_19.5_1_0_0_1_1_31
1_19.5_0_0_0_1_1_31
1_19.5_-1_0_0_1_1_31
1_20.5_-1_0_0_1_1_31
1_21.5_-1_0_0_1_1_31
1_22.5_-1_0_0_1_1_31
1_23.5_-1_0_0_1_1_31
1_24.5_-1_0_0_1_1_31
1_25.5_-1_0_0_1_1_31
1_26.5_-1_0_0_1_1_31
1_27.5_-1_0_0_1_1_31
1_27.5_0_0_0_1_1_31
1_27.5_1_0_0_1_1_31
1_27.5_2_0_0_1_1_31
1_21.5_2_0_0_1_1_31
1_22.5_2_0_0_1_1_31
1_23.5_2_0_0_1_1_31
1_24.5_2_0_0_1_1_31
1_25.5_2_0_0_1_1_31
1_26.5_2_0_0_1_1_31
1_32.5_-1_0_0_1_1_31
1_33.5_-1_0_0_1_1_31
1_33.5_-2_0_0_1_1_31
1_34.5_-3_0_0_1_1_31
1_34.5_-2_0_0_1_1_31
1_34.5_-1_0_0_1_1_31
1_30.5_0_0_0_1_1_31
1_31.5_0_0_0_1_1_31
1_32.5_0_0_0_1_1_31
1_33.5_0_0_0_1_1_31
1_34.5_0_0_0_1_1_31
1_35.5_0_0_0_1_1_31
1_36.5_0_0_0_1_1_31
10_41.5_-2_0_0_1_1_31
1_41.5_-1_0_0_1_1_31
1_41.5_0_0_0_1_1_31
1_41.5_1_0_0_1_1_31
1_41.5_2_0_0_1_1_31
1_42.5_1_0_0_1_1_31
1_44.5_1_0_0_1_1_31
1_46.5_1_0_0_1_1_31
1_48.5_1_0_0_1_1_31
1_49.5_2_0_0_1_1_31
1_49.5_1_0_0_1_1_31
1_49.5_0_0_0_1_1_31
1_49.5_-1_0_0_1_1_31
1_49.5_-2_0_0_1_1_31
10_49.5_-3_0_0_1_1_31
1_56.5_0_0_0_1_1_31
1_57.5_0_0_0_1_1_31
1_58.5_0_0_0_1_1_31
1_59.5_0_0_0_1_1_31
1_60.5_0_0_0_1_1_31
1_61.5_0_0_0_1_1_31
1_62.5_0_0_0_1_1_31
1_0_-9_0_0_1_1_31
1_1_-9_0_0_1_1_31
1_2_-9_0_0_1_1_31
1_3_-9_0_0_1_1_31
1_4_-9_0_0_1_1_31
1_5_-9_0_0_1_1_31
1_6_-9_0_0_1_1_31
1_7_-9_0_0_1_1_31
1_8_-9_0_0_1_1_31
1_9_-9_0_0_1_1_31
1_10_-9_0_0_1_1_31
1_11_-9_0_0_1_1_31
1_12_-9_0_0_1_1_31
1_13_-9_0_0_1_1_31
1_14_-9_0_0_1_1_31
1_-1_0_0_0_1_1_31
1_-1_-1_0_0_1_1_31
1_-1_-2_0_0_1_1_31
1_-1_-3_0_0_1_1_31
1_-1_-4_0_0_1_1_31
1_-1_-5_0_0_1_1_31
1_-1_-6_0_0_1_1_31
1_-1_-7_0_0_1_1_31
1_-1_-8_0_0_1_1_31
1_15_-9_0_0_1_1_31
1_16_-9_0_0_1_1_31
1_17_-9_0_0_1_1_31
1_18_-9_0_0_1_1_31
1_19_-9_0_0_1_1_31
1_20_-9_0_0_1_1_31
1_21_-9_0_0_1_1_31
1_22_-9_0_0_1_1_31
1_23_-9_0_0_1_1_31
1_24_-9_0_0_1_1_31
1_25_-9_0_0_1_1_31
1_26_-9_0_0_1_1_31
1_27_-9_0_0_1_1_31
1_28_-9_0_0_1_1_31
1_29_-9_0_0_1_1_31
1_30_-9_0_0_1_1_31
1_31_-9_0_0_1_1_31
1_32_-9_0_0_1_1_31
1_33_-9_0_0_1_1_31
1_34_-9_0_0_1_1_31
1_35_-9_0_0_1_1_31
1_36_-9_0_0_1_1_31
1_37_-9_0_0_1_1_31
1_38_-9_0_0_1_1_31
1_39_-9_0_0_1_1_31
1_40_-9_0_0_1_1_31
1_41_-9_0_0_1_1_31
1_42_-9_0_0_1_1_31
1_43_-9_0_0_1_1_31
1_44_-9_0_0_1_1_31
1_45_-9_0_0_1_1_31
1_46_-9_0_0_1_1_31
1_47_-9_0_0_1_1_31
1_48_-9_0_0_1_1_31
1_49_-9_0_0_1_1_31
1_50_-9_0_0_1_1_31
1_51_-9_0_0_1_1_31
1_52_-9_0_0_1_1_31
1_53_-9_0_0_1_1_31
1_54_-9_0_0_1_1_31
1_55_-9_0_0_1_1_31
1_56_-9_0_0_1_1_31
1_57_-9_0_0_1_1_31
1_58_-9_0_0_1_1_31
1_59_-9_0_0_1_1_31
1_60_-9_0_0_1_1_31
1_61_-9_0_0_1_1_31
1_62_-9_0_0_1_1_31
1_63_-9_0_0_1_1_31
1_63.5_-8_0_0_1_1_31
1_63.5_-7_0_0_1_1_31
1_63.5_-6_0_0_1_1_31
1_63.5_-5_0_0_1_1_31
1_63.5_-4_0_0_1_1_31
1_63.5_-3_0_0_1_1_31
1_63.5_-2_0_0_1_1_31
1_63.5_-1_0_0_1_1_31
1_63.5_0_0_0_1_1_31
2_0.555232_-0.8_0_0_0.8_0.8
10_5.5_-2_0_0_1_0.2_31
10_6.5_-2_0_0_1_0.2_31
10_7.5_-2_0_0_1_0.2_31
10_9.5_-3_0_0_1_0.2_31
10_10.5_-3_0_0_1_0.2_31
10_11.5_-3_0_0_1_0.2_31
10_13.5_-4_0_0_1_0.2_31
10_14.5_-4_0_0_1_0.2_31
10_15.5_-4_0_0_1_0.2_31
10_23.5_-4_0_0_1_0.2_31
11_60.5_-1_0_0_1_1_levels/level3_0
3_19.5_-4_0_0_4_2_31_19.5_-2_23.5_-4
3_17.5_-2_0_0_2_2_31_17.5_0_19.5_-2
3_24.5_-4_0_0_4_2_31_24.5_-4_28.5_-2
3_28.5_-2_0_0_2_2_31_28.5_-2_30.5_0
3_37.5_-2_0_0_4_2_31_37.5_0_41.5_-2
3_50.5_-3_0_0_6_3_31_50.5_-3_56.5_0