9_0_-8_0_0_31.9375_22.9375_35
2_7.7381_9.2_0_0_0.8_0.8
1_1_2_0_0_1_1_31
1_3_10_0_0_1_1_31
1_4_10_0_0_1_1_31
1_5_10_0_0_1_1_31
1_6_10_0_0_1_1_31
1_7_10_0_0_1_1_31
1_8_10_0_0_1_1_31
1_9_10_0_0_1_1_31
1_10_10_0_0_1_1_31
1_10_11_0_0_1_1_31
1_11_11_0_0_1_1_31
1_12_11_0_0_1_1_31
1_12_12_0_0_1_1_31
1_13_12_0_0_1_1_31
1_14_12_0_0_1_1_31
1_15_12_0_0_1_1_31
1_2_10_0_0_1_1_31
1_2_9_0_0_1_1_31
1_2_8_0_0_1_1_31
1_2_7_0_0_1_1_31
1_1_6_0_0_1_1_31
1_16_12_0_0_1_1_31
1_17_12_0_0_1_1_31
1_17_11_0_0_1_1_31
1_17_10_0_0_1_1_31
1_17_9_0_0_1_1_31
1_17_8_0_0_1_1_31
1_17_7_0_0_1_1_31
1_17_6_0_0_1_1_31
1_18_6_0_0_1_1_31
1_19_6_0_0_1_1_31
1_20_6_0_0_1_1_31
1_21_6_0_0_1_1_31
1_22_6_0_0_1_1_31
1_22_7_0_0_1_1_31
1_22_8_0_0_1_1_31
1_23_9_0_0_1_1_31
1_24_9_0_0_1_1_31
1_25_9_0_0_1_1_31
1_26_9_0_0_1_1_31
1_27_9_0_0_1_1_31
11_6_9_0_0_1_1_levels/level1
11_10_6_0_0_1_1_levels/level2
10_9_7_0_0_1_0.3_31
10_10_7_0_0_1_0.3_31
10_11_7_0_0_1_0.3_31
11_15_11_0_0_1_1_levels/level3
10_14_8_0_0_1_0.3_31
10_15_8_0_0_1_0.3_31
10_16_8_0_0_1_0.3_31